##########
#..#.....#
#..#.....#
#.##.....#
#..#.....#
#........#
##########

##########
#..#.....#
#..#.....#
#.#......#
#..#.....#
#........#
##########